111111111111111111111111111111111
10E000000000000C00000C00000000001
101001010010000010100100000001011
101E01001010101000100100000001011
101001001010101000100100000001011
101001001010101000100100000001011
101001001010101000100100000001011
101001001010101000100100000001011
101001001010101000100100000001011
101001001010101000100100000001011
101001001010101000100100000001011
101001001010101000100100000001011
101001001010101000100100000001011
101001001010101000100100000001011
101001001010101000100100000001011
1P0000000C00C00000000000000000001
111111111111111111111111111111111