1111111111
100P111011
1000111011
101000E111
1C11111111
1111111111