111111111111111111111111111111
1P011111C011C001000C0100001111
110000000001110100100001100011
110111011C00010000001101C01011
110000000000C000101110011000C1
1C1011011111000010000010101111
1000000000C0001101110C0001C001
111001111111000000111110111001
10001100C000000100C00000000001
1C0000001001110000111011100C11
101000110110010011001000111101
1000100C01E1111000000011010111
10C01101110000C0101000000000C1
111111111111111111111111111111